#########################################
#S  #   #     #     #     #     #     # #
### # # ### # # ### # # # ##### # # # # #
#   # #   # #     #   # #     #   # #   #
# ### ### ############# ##### ##### ### #
#   # #   #   #       # #   # #   #   # #
### # # ### # # ##### # ### # # # # # ###
#   # # #   # #   # #   #   # # # # #   #
# ### # # ### ### # ##### # # # # ### # #
# #   #   # #     #       # #   #   # # #
# ### ##### ####### # # ########### ### #
#   #   #       #   # # #         #     #
### ### # ##### # ### # # ### ######### #
# #   # # # #   #   # # # # # #       # #
# ### # # # # ### ### ### # # # ### ### #
#   # # # #   #   #   #   # #   # #     #
# ### # # ### # ### # # ### ##### #######
#   # # #   # # # # # #   #       #     #
# # # # # # ### # # ##### ##### # # # # #
# #     # #       #             #   # #E#
#########################################