#########################################
#S#     # #     #           #           #
# # # # # # # # # ##### ##### ####### # #
# # # # #   # # # #   #   #   # #     # #
# ### # # ### ### # # ### # ### # ##### #
#     # #   #       #   #       #   #   #
####### ############### ########### #####
#     #       #       #     #     #     #
# # # ####### # ##### ####### ### ##### #
# # #   #   #   #   #       #   #       #
### ### # # ####### ####### ### #########
#   #   # #     #   #     #   #     #   #
# ### ### ### # # # ##### ### # ### # # #
# #     #   # #   #       #   #   #   # #
# ######### # ########### # ##### ##### #
#         # #         #   # #     #     #
# ##### ### ######### ### # ##### # ### #
# #   #     #       #   # # #   # #   # #
# # # ######### ### ### ### # # ##### # #
#   #           #     #       #       #E#
#########################################